Matthew 	Harrison
Emma 	Miah
Rebecca 	Bell
Scott 	Gardner
Terry 	Edwards
Holly 	Matthews
Anne 	Jenkins
Brett 	Naylor
Melissa 	Mitchell
Craig 	Carr
Fiona 	Clark
Patrick 	Martin
Kate 	Watson
Kirsty 	Norris
Andrea 	Hayes
Abigail 	Hughes
Melanie 	Watson
Frances 	Ward
Sylvia 	King
Wayne 	Hartley
Iain 	White
Joanna 	Wood
Bethan 	Webster
